border_size=1
usage=map

Wot         , Wot         , Wot         , Wot         , Wot         , Wot         , Wot         
Wot         , Wot         , Wot         , Wot         , Wot         , Wot         , Wot         
Wot         , Wot         , Mm          , Mm          , Mm          , Wot         , Wot         
Wot         , Kh          , Kh          , Kh          , Kh          , Mm          , Wot         
Wot         , Mm          , Mm          , 1 Kh        , Mm          , Kh          , Wot         
Wot         , Co          , Co          , Gg          , Co          , Gg          , Wot         
Wot         , Wot         , Wot         , 2 Kud       , Wot         , Wot         , Wot         
Wot         , Wot         , Wot         , Wot         , Wot         , Wot         , Wot         
